29 22 22 22 22 22 22 22 22 26
8 30 30 30 30 30 11 30 30 2
8 30 30 30 30 30 30 30 30 2
8 30 30 30 30 30 30 30 30 2
8 30 30 30 11 30 30 30 30 2
8 30 30 30 30 30 30 30 30 2
8 30 30 30 30 30 30 30 30 2
8 30 30 30 30 30 30 30 30 2
8 30 30 30 30 30 30 30 30 2
19 36 36 36 36 36 36 36 36 13