49 2 2 3 100 101 2 3 2 50
56 8 8 8 107 108 8 8 8 57
56 29 29 29 29 29 29 29 29 57
56 29 29 29 29 29 29 29 29 57
56 29 29 29 29 29 29 29 29 57
56 30 29 29 29 29 29 29 29 57
56 30 37 29 29 29 29 29 29 57
56 29 29 29 29 29 29 29 29 57
56 29 29 29 29 29 29 29 29 57
0 8 8 8 8 8 8 8 8 0
