0 0 0 0 0 0 0 0 0 0 0 0 0 0 0 0 0 0 0 0 
0 0 0 0 0 0 0 0 0 0 0 0 0 0 0 0 0 0 0 0 
49 1 1 2 2 3 2 1 1 100 101 2 3 2 1 1 1 1 3 50
56 8 8 8 8 8 8 8 8 107 108 8 8 8 8 8 8 8 8 57 
56 30 29 29 29 29 29 30 29 29 29 29 29 29 29 30 29 29 29 57 
56 29 29 29 30 29 29 29 29 29 30 30 29 29 29 29 29 30 30 57 
56 29 31 29 29 29 29 29 29 29 29 29 29 29 29 29 29 29 30 57 
56 29 29 29 29 29 30 29 29 29 29 29 29 29 29 29 29 29 29 57 
56 30 29 29 29 29 29 37 29 29 29 38 29 29 29 29 29 29 29 57 
56 29 29 29 29 29 29 29 29 29 29 29 29 29 29 29 29 29 29 57 
56 29 29 29 29 29 29 29 29 29 29 29 31 30 29 29 29 29 29 57
56 29 29 29 29 29 29 31 29 29 29 29 29 30 29 29 29 29 29 57 
56 30 29 29 29 29 29 29 29 29 29 29 29 29 29 29 29 29 29 57 
56 30 37 29 29 29 38 29 29 29 29 29 29 29 29 29 29 29 29 57 
56 29 29 29 29 29 29 29 29 29 29 29 29 29 29 29 29 29 29 57 
56 29 29 29 29 29 29 29 29 29 29 29 29 29 29 29 29 31 30 57 
56 29 29 29 29 29 29 29 29 29 29 29 31 29 29 29 29 29 30 57 
56 30 29 29 29 29 29 29 29 29 29 29 29 29 29 29 29 29 29 57 
56 30 37 29 29 29 29 29 29 29 29 38 29 29 29 29 29 29 29 57 
56 29 29 29 29 29 29 29 29 29 29 29 29 29 29 29 29 29 29 57 
56 29 29 29 29 29 29 29 29 29 29 29 29 29 29 29 29 31 30 57 
0 8 8 8 8 8 8 8 8 8 8 8 8 8 8 8 8 8 8 0 